Address A,Address B,Packets,Bytes,Packets A → B,Bytes A → B,Packets B → A,Bytes B → A,Rel Start,Duration,Bits/s A → B,Bits/s B → A
3.214.17.10,10.61.81.49,865,545075,444,472810,421,72265,166.398313779,1170.967005613,3230.21911110115,493.711605219273
3.215.87.246,10.61.81.49,185,23088,99,14166,86,8922,247.96953922,1057.445814475,107.171448833305,67.4984940343602
10.61.81.49,192.168.108.122,192,22635,100,9614,92,13021,0,1295.196827287,59.3824802374668,80.4263860174803
10.61.81.49,224.0.0.251,11,912,11,912,0,0,0.046859668,731.433325451,9.974935166512,0
10.61.81.49,239.255.255.250,52,11128,52,11128,0,0,0.060526787,1265.632531286,70.339532051648,0
10.61.81.49,216.58.196.195,403,255477,239,212046,164,43431,0.064881282,374.950107611,4524.24993503385,926.651287590687
10.61.81.49,172.217.166.10,92,42261,44,12962,48,29299,0.172294527,50.045720938,2072.02530119339,4683.55726737118
10.61.81.49,74.125.24.188,47,15886,26,3270,21,12616,0.211192126,50.577052298,517.230617669557,1995.52950229943
10.61.81.49,172.217.166.205,85,49978,41,19095,44,30883,0.444616007,63.445237946,2407.74571812652,3894.12992997651
10.61.81.49,216.58.200.164,651,394916,269,58803,382,336113,0.444764965,1304.214884388,360.69516276127,2061.70319951667
10.61.81.49,172.217.167.3,108,73910,50,28832,58,45078,2.073756793,1293.47768238,178.322365466401,278.801872589291
10.61.81.49,35.224.99.156,21,2066,11,916,10,1150,2.416068723,1200.629226272,6.1034662822208,7.66264871676192
10.61.81.49,216.58.196.206,142,96580,66,23149,76,73431,5.699801936,1295.119003832,142.99226515251,453.586116999178
10.61.81.49,216.58.200.174,644,361608,324,166024,320,195584,22.899143065,1276.733881647,1040.30449813599,1225.52712236442
10.61.81.49,172.217.166.14,35,26338,16,9130,19,17208,23.092649613,385.826016504,189.30812562051,356.803310589017
10.61.81.49,172.217.27.174,186,134284,80,31716,106,102568,23.092813355,27.124886307,9354.06685684509,30250.5968398565
10.61.81.49,216.58.196.202,39,27940,19,11987,20,15953,23.093100136,1192.645683746,80.4061099678814,107.009149271512
10.61.81.49,172.217.167.33,288,224508,118,27274,170,197234,23.354557757,1282.257060283,170.162447732473,1230.54264926547
10.61.81.49,172.217.167.14,109,55511,56,25050,53,30461,23.594684263,1295.185365593,154.72688722687,188.149130212282
10.61.81.49,192.168.108.121,180,20078,92,8351,88,11727,23.961430335,1311.525255956,50.9391639212484,71.5319812363167
10.61.81.49,172.217.161.3,97,49476,47,24844,50,24632,24.129711547,1281.20717078,155.128697788196,153.804946221174
10.61.81.49,172.217.166.214,3795,3939857,870,107847,2925,3832010,24.130356704,1281.271558566,673.37481600358,23926.2939968092
10.61.81.49,172.217.166.3,392,399491,177,34221,215,365270,24.279728953,1282.917511454,213.394857857793,2277.7458206866
10.61.81.49,172.217.166.206,53,35340,24,13211,29,22129,24.28049058,1291.679700674,81.8221420874323,137.055649250836
10.61.81.49,172.217.27.163,62,33428,32,14982,30,18446,24.347307243,225.877073998,530.624900874452,653.311101423718
10.61.81.49,172.217.166.1,981,1114494,180,21922,801,1092572,24.348064546,1191.507308808,147.18835436725,7335.73007516353
10.61.81.49,172.217.167.202,51,21521,24,6326,27,15195,62.882181018,17.816287554,2840.54687861377,6822.9702530092
10.61.81.49,172.217.194.188,75,10322,38,3299,37,7023,62.940002517,1266.046264224,20.8459996650885,44.3775252039758
10.61.81.49,52.45.119.166,323,187831,159,22008,164,165823,72.976978633,494.859409638,355.785899127986,2680.72905993729
10.61.81.49,13.224.17.4,1326,2054138,512,39498,814,2014640,72.978275942,709.765450595,445.194958045801,22707.6705219857
10.61.81.49,172.217.166.232,70,51056,31,11728,39,39328,73.188865632,135.235188119,693.783927874155,2326.49508146613
10.61.81.49,172.217.166.238,341,196849,155,64319,186,132530,77.502292187,1214.834440391,423.55730368855,872.744437224513
10.61.81.49,74.125.24.157,52,22235,27,8566,25,13669,78.872432206,118.30381293,579.254364697001,924.331999888315
10.61.81.49,91.189.89.199,11,990,6,540,5,450,84.711405408,929.716744875,4.64657652324077,3.87214710270064
10.61.81.49,172.217.167.46,435,256201,182,73577,253,182624,165.928737108,824.606537514,713.814374761741,1771.74438175637
10.61.81.49,172.217.160.227,224,110261,109,50533,115,59728,193.236914535,1039.666947389,388.839907833235,459.593335346476
10.61.81.49,216.58.207.195,72,33031,37,8517,35,24514,195.956048143,12.711881389,5360.02483935701,15427.4567232591
10.61.81.49,13.224.17.184,223,159363,109,10393,114,148970,208.668658626,359.167677654,231.490763709801,3318.11595014423
10.61.81.49,34.205.95.128,303,150534,158,35926,145,114608,245.909476595,907.509991949,316.69954331054,1010.30733340017
10.61.81.49,172.217.160.234,214,64147,115,26613,99,37534,247.362025644,1072.049589912,198.595290743478,280.091520789302
10.61.81.49,99.86.55.170,181,66591,91,10620,90,55971,250.044463637,317.791818926,267.344830609952,1408.99788268076
10.61.81.49,216.239.32.116,24,10069,11,4237,13,5832,255.323513914,0.64096982800001,52882.3643786232,72789.6976766889
10.61.81.49,35.222.85.5,31,3066,16,1341,15,1725,302.416938417,601.266255001,17.8423450688783,22.9515624487808
10.61.81.49,172.217.160.238,46,34854,18,4390,28,30464,358.571676618,1.89060649699996,18576.0495670193,128906.78223455
10.61.81.49,172.217.161.14,498,553597,100,12972,398,540625,359.173515881,856.681865527,121.137150412494,5048.54856165236
10.61.81.49,52.216.232.91,23,5609,12,1443,11,4166,360.954718696,44.538121142,259.193690797923,748.302782996638
10.61.81.49,10.61.84.226,12,712,6,324,6,388,389.37319901,2.73956385100001,946.136005938993,1133.02706884052
10.61.81.49,172.217.166.195,70,29887,35,9151,35,20736,409.293222284,903.127834558,81.0605068282817,183.681638027674
10.61.81.49,172.217.27.162,60,29418,30,12518,30,16900,409.2960302,806.559346118,124.161973303015,167.62560703155
10.61.81.49,172.217.167.195,55,14705,27,6675,28,8030,422.752807335,240.534479803,222.005593725004,267.071897769555
10.61.81.49,157.240.16.35,889,722749,373,199555,516,523194,782.763263297,90.193137427,17700.2380174669,46406.5462118742
10.61.81.49,180.149.52.83,1095,1752545,445,68779,650,1683766,782.826376385,188.355084221,2921.24846151965,71514.5442222058
10.61.81.49,157.240.16.20,160,67971,80,9719,80,58252,782.829833468,188.351650724,412.802328522904,2474.18059894189
10.61.81.49,180.149.52.84,1401,2363624,508,79229,893,2284395,788.247152244,138.750157349,4568.15337805862,131712.715496475
10.61.81.49,157.240.16.16,215,35494,98,17383,117,18111,789.968386241,81.9041857320001,1697.88636267056,1768.9938396322
10.61.81.49,180.149.59.13,18194,21423979,2911,232126,15283,21191853,898.352136802,98.460835811,18860.3720931702,1721850.34388119
10.61.81.49,74.125.169.7,24,16367,11,5495,13,10872,949.645234599,0.218493147000004,201196.241637726,398071.981635188
10.61.81.49,10.61.90.172,10,596,5,270,5,326,1015.186534973,5.10885470000005,422.795347849681,510.486234811097
10.61.81.49,172.217.167.206,879,582855,333,171327,546,411528,1030.698827707,303.550953354,4515.27489818684,10845.7046951212
10.61.81.49,180.149.59.78,27568,33937362,3289,271129,24279,33666233,1034.84021916,252.842664546,8578.58385527885,1065207.34735811
10.61.81.49,172.217.17.195,29,14967,13,4951,16,10016,1069.729017461,16.6000515389999,2386.01668837869,4826.97296521933
10.61.81.49,172.217.167.210,31,7294,14,2095,17,5199,1232.826027016,91.9468836340002,182.279152240919,452.348120525317
10.61.81.49,172.217.167.18,31,7293,15,2161,16,5132,1233.105996795,91.60640236,188.720433884748,448.178281673543
10.61.81.49,216.58.221.35,32,8085,16,2259,16,5826,1262.871290068,45.4604156150001,397.532661228838,1025.24359642285
10.61.81.49,172.217.167.227,6,3075,3,1543,3,1532,1300.883237463,0.148951118000014,82872.8254325615,82282.0275843709
10.61.81.49,180.149.59.79,3338,4029611,448,44673,2890,3984938,1303.771515006,19.0085020429999,18801.2710939319,1677118.16154077
