Address A,Port A,Address B,Port B,Packets,Bytes,Packets A → B,Bytes A → B,Packets B → A,Bytes B → A,Rel Start,Duration,Bits/s A → B,Bits/s B → A
10.61.81.49,47581,192.168.108.122,53,2,216,1,100,1,116,0,0.064369141,12428.3156116686,14416.8461095356
10.61.81.49,36027,192.168.108.122,53,2,404,1,89,1,315,0.020718832,0.150518538,4730.31434838943,16742.1238173334
10.61.81.49,37255,192.168.108.122,53,2,219,1,87,1,132,0.024483437,0.18626755,3736.56066233759,5669.26445320186
10.61.81.49,5353,224.0.0.251,5353,11,912,11,912,0,0,0.046859668,731.433325451,9.974935166512,0
10.61.81.49,35602,239.255.255.250,1900,4,856,4,856,0,0,0.060526787,3.001374605,2281.62122401912,0
10.61.81.49,49182,172.217.166.10,443,40,18443,19,6436,21,12007,0.172294527,5.799475822,8878.04373710518,16562.8761888474
10.61.81.49,57988,192.168.108.122,53,2,196,1,90,1,106,0.291305569,0.152824675,4711.28108075479,5548.84216177787
10.61.81.49,53257,192.168.108.122,53,2,186,1,85,1,101,0.292561544,0.151591602,4485.73661752054,5330.11056905382
10.61.81.49,56649,172.217.166.205,443,27,16327,13,7469,14,8858,0.444616007,5.526439758,10812.0241270166,12822.7218793832
10.61.81.49,57438,216.58.200.164,443,83,62588,34,8901,49,53687,0.444764965,5.526899603,12883.8960565429,77710.114322842
10.61.81.49,45834,192.168.108.122,53,2,232,1,100,1,132,1.41515227,0.085265655,9382.44126547788,12384.8224704308
10.61.81.49,54211,192.168.108.122,53,2,261,1,100,1,161,1.415239961,0.11217391,7131.78313923442,11482.1708541674
10.61.81.49,52862,192.168.108.122,53,2,228,1,88,1,140,1.570086418,0.502755327,1400.28352200831,2227.72378501322
10.61.81.49,58463,172.217.167.3,443,16,11747,8,4569,8,7178,2.073756793,3.897711679,9377.8101127731,14732.7469882874
10.61.81.49,44316,192.168.108.122,53,2,207,1,85,1,122,5.661640147,0.03764115,18065.335410847,25929.0696485098
10.61.81.49,53094,216.58.196.206,443,17,11479,8,4228,9,7251,5.699801936,0.354362399,95450.3076383112,163696.82608453
10.61.81.49,53082,172.217.166.10,443,38,17817,17,5409,21,12408,17.409436842,2.116882008,20441.3849409032,46891.6073852332
10.61.81.49,39333,239.255.255.250,1900,4,856,4,856,0,0,17.456510805,3.001868417,2281.24589379695,0
10.61.81.49,42355,172.217.166.205,443,21,14216,10,5914,11,8302,17.929417452,0.937663146000002,50457.352623732,70831.4070818774
10.61.81.49,37832,216.58.200.164,443,114,65243,49,8264,65,56979,17.929692892,32.287888857,2047.57890157526,14117.7393795809
10.61.81.49,56130,172.217.167.3,443,19,14594,8,4561,11,10033,18.771721261,1.3671384,26689.3242117989,58709.4912994909
10.61.81.49,40848,192.168.108.122,53,2,220,1,90,1,130,22.849612954,0.048612807999998,14810.9115605918,21393.5389208549
10.61.81.49,48303,216.58.196.206,443,43,31107,20,8689,23,22418,22.850091572,27.36723163,2539.97192481101,6553.23864776307
10.61.81.49,55900,216.58.200.174,443,28,19291,14,7941,14,11350,22.899143065,27.31744047,2325.54730263864,3323.88387922787
10.61.81.49,42426,192.168.108.122,53,2,180,1,82,1,98,23.021848396,0.070093384,9358.94320639452,11185.0784661788
10.61.81.49,36452,192.168.108.122,53,2,382,1,86,1,296,23.022038947,0.069925803,9839.00034726805,33864.4663115272
10.61.81.49,34561,192.168.108.122,53,2,198,1,91,1,107,23.022329324,0.069630714999999,10455.1561764088,12293.4253942389
10.61.81.49,56302,172.217.166.14,443,20,14674,9,4647,11,10027,23.092649613,27.125139289,1370.53674098831,2957.25670365607
10.61.81.49,44986,172.217.27.174,443,186,134284,80,31716,106,102568,23.092813355,27.124886307,9354.06685684509,30250.5968398565
10.61.81.49,46510,216.58.196.202,443,20,14674,9,4647,11,10027,23.093100136,27.123565937,1370.6162414761,2957.42824473441
10.61.81.49,59766,192.168.108.122,53,2,229,1,84,1,145,23.093458891,0.244533537999999,2748.08930298961,4743.72558254159
10.61.81.49,44962,172.217.167.3,443,19,14596,8,4569,11,10027,23.093466241,27.123260487,1347.62559307791,2957.46154996546
10.61.81.49,59366,192.168.108.122,53,1,82,1,82,0,0,23.093585966,0,0,0
10.61.81.49,38595,192.168.108.122,53,3,277,2,174,1,103,23.093898738,1.034241335,1345.91410427432,796.719268622153
10.61.81.49,55440,172.217.167.33,443,15,10347,7,3169,8,7178,23.354557757,26.863289089,943.741472461061,2137.63846302477
10.61.81.49,39079,192.168.108.122,53,2,220,1,90,1,130,23.36171616,0.766459563999998,939.384194310872,1356.88828067126
10.61.81.49,39185,172.217.167.14,443,19,12898,11,7033,8,5865,23.594684263,26.622710599,2113.38360122178,1762.40506486077
10.61.81.49,34287,192.168.108.121,53,2,180,1,82,1,98,23.961430335,0.166733236000002,3934.42852629568,4702.12189728021
10.61.81.49,41514,192.168.108.121,53,2,220,1,90,1,130,24.128691165,0.148749560000002,4840.35045212899,6991.61731974188
10.61.81.49,53708,172.217.161.3,443,17,11812,8,4569,9,7243,24.129711547,26.087815762,1401.11385075183,2221.11350864423
10.61.81.49,43440,172.217.166.214,443,136,101452,56,9963,80,91489,24.130356704,26.086427431,3055.38196868166,28057.1957174261
10.61.81.49,35504,192.168.108.121,53,2,209,1,86,1,123,24.131442604,0.146109585000001,4708.79442987942,6734.67110319963
10.61.81.49,39991,192.168.108.121,53,2,188,1,86,1,102,24.131714937,0.145775032,4719.60109053519,5597.66640970453
10.61.81.49,38773,172.217.166.3,443,17,13153,8,5897,9,7256,24.279728953,25.93773252,1818.81742992082,2237.97511811183
10.61.81.49,38597,172.217.166.206,443,17,13153,8,5897,9,7256,24.28049058,25.935837642,1818.95031312211,2238.13862506597
10.61.81.49,40161,192.168.108.121,53,2,188,1,86,1,102,24.28084465,0.032719069000002,21027.4931722523,24939.5849252294
10.61.81.49,34847,192.168.108.121,53,2,237,1,96,1,141,24.282629349,0.034758944,22095.0325763636,32452.0790965341
10.61.81.49,54011,172.217.27.163,443,12,7493,6,3099,6,4394,24.347307243,25.870337544,958.317608258262,1358.77624094443
10.61.81.49,41475,172.217.166.1,443,13,8885,6,3099,7,5786,24.348064546,25.868810634,958.374173082982,1789.33622634983
10.61.81.49,45698,192.168.108.121,53,2,244,1,101,1,143,24.353774928,0.232581369999998,3474.05297337446,4918.70866527275
10.61.81.49,51867,192.168.108.121,53,2,180,1,82,1,98,24.353935269,0.232382848,2822.92779198575,3373.74297090979
10.61.81.49,46639,192.168.108.121,53,4,478,2,181,2,297,24.354755071,0.21351426,6781.74844153266,11128.062359863
10.61.81.49,53160,192.168.108.121,53,4,478,2,181,2,297,24.354906867,0.213366231999998,6786.45344404831,11135.7827231069
10.61.81.49,52680,192.168.108.121,53,4,454,2,169,2,285,24.355179811,0.213073265000002,6345.23528796533,10700.5447163912
10.61.81.49,36449,192.168.108.121,53,2,220,1,90,1,130,31.405530567,0.049002868999999,14693.0172598673,21223.2471531417
10.61.81.49,52621,216.58.200.174,443,15,9993,8,5398,7,4595,46.024258848,4.192218304,10300.9902797276,8768.62733148355
10.61.81.49,57438,192.168.108.121,53,2,216,1,100,1,116,62.679149314,0.099279443999997,8058.06285538852,9347.35291225069
10.61.81.49,47764,192.168.108.121,53,2,404,1,89,1,315,62.69192534,0.187593147000001,3795.44781558569,13433.3265383089
10.61.81.49,52541,192.168.108.121,53,2,219,1,87,1,132,62.693532162,0.245986757000004,2829.42060982571,4292.91402870107
10.61.81.49,34393,239.255.255.250,1900,4,856,4,856,0,0,62.746128225,3.00223200200001,2280.96962374595,0
10.61.81.49,49914,192.168.108.121,53,2,196,1,90,1,106,62.81397,0.173012728000003,4161.54353684306,4901.37349894849
10.61.81.49,57227,192.168.108.121,53,2,186,1,85,1,101,62.814162362,0.201747090000005,3370.55667073058,4005.01439698575
10.61.81.49,49509,172.217.167.202,443,35,15389,15,5143,20,10246,62.882181018,17.816287554,2309.34754927452,4600.73400541838
10.61.81.49,46532,172.217.166.205,443,21,14171,9,4529,12,9642,62.987620444,0.902233508999998,40158.1183125843,85494.4969684119
10.61.81.49,38977,216.58.200.164,443,120,64819,50,8500,70,56319,63.016385335,26.088070611,2606.55534914598,17270.4224363003
10.61.81.49,55223,192.168.108.121,53,2,228,1,88,1,140,63.922973783,0.278156393999993,2530.950268215,4026.51179034205
10.61.81.49,36044,172.217.167.3,443,13,8877,6,3091,7,5786,64.201858554,0.486096117000002,50870.5976764671,95223.9657573726
10.61.81.49,48597,192.168.108.121,53,2,207,1,85,1,122,68.007419361,0.057357311999994,11855.5067573612,17016.1391105656
10.61.81.49,60716,216.58.196.206,443,34,24229,14,4602,20,19627,68.066027843,15.619653759,2357.03048019145,10052.4635451364
10.61.81.49,56858,172.217.27.163,443,13,8869,6,3083,7,5786,68.631576805,0.375120497000012,65749.5396739124,123395.016721783
10.61.81.49,57113,172.217.166.3,443,30,11619,14,5773,16,5846,68.631754658,23.888141279,1933.34422551328,1957.79150222599
10.61.81.49,37784,172.217.166.206,443,14,10261,7,4475,7,5786,68.631887982,0.400379855000011,89415.0880792916,115610.212207102
10.61.81.49,49031,192.168.108.121,53,2,188,1,86,1,102,68.865879787,0.111851872000003,6150.99226948999,7295.36292427883
10.61.81.49,49448,172.217.167.14,443,22,11122,10,5598,12,5524,68.978574946,15.785814889,2836.9773948893,2799.47537144846
10.61.81.49,46326,192.168.108.121,53,4,470,2,177,2,293,69.637705712,0.042441988000007,33363.1874171341,55228.327193335
10.61.81.49,56986,192.168.108.121,53,4,462,2,173,2,289,69.638032022,0.042163107999997,32824.9046536157,54834.6673115315
10.61.81.49,48918,192.168.108.121,53,4,470,2,177,2,293,69.638270721,0.041916305000001,33781.6036027024,55920.9596361118
10.61.81.49,41602,192.168.108.121,53,1,90,1,90,0,0,72.000705742,0,0,0
10.61.81.49,46834,192.168.108.121,53,2,226,1,81,1,145,72.881577875,0.094512678000001,6856.22303496673,12273.4856798787
10.61.81.49,49355,192.168.108.122,53,2,220,1,90,1,130,72.881753231,0.076410523999996,9422.78579322443,13610.6905902131
10.61.81.49,35155,192.168.108.122,53,2,262,1,99,1,163,72.882296796,0.093813803999993,8442.25440426722,13899.8734130864
10.61.81.49,50581,216.58.200.174,443,25,14361,13,7023,12,7338,72.960075877,3.984231166,14101.591413534,14734.0848344742
10.61.81.49,49300,192.168.108.122,53,2,250,1,95,1,155,72.97931976,0.205232257000006,3703.12158093149,6041.93521099349
10.61.81.49,36549,192.168.108.122,53,2,250,1,95,1,155,72.979588707,0.20501483999999,3707.04871900999,6048.34264680577
10.61.81.49,55401,192.168.108.122,53,2,274,1,94,1,180,72.979864772,0.204726488999995,3673.1934576381,7033.77470611551
10.61.81.49,45871,172.217.166.232,443,46,37441,18,5486,28,31955,73.188865632,3.7054897,11844.0485747403,68989.5319368989
10.61.81.49,34000,192.168.108.122,53,2,220,1,90,1,130,76.835996312,0.048459611999988,14857.7334874283,21461.1705929519
10.61.81.49,52661,192.168.108.122,53,2,220,1,90,1,130,77.47352914,0.162807487000009,4422.40104105261,6387.91261485377
10.61.81.49,49524,172.217.166.238,443,41,16305,18,6559,23,9746,77.502292187,15.134605242,3467.02138317986,5151.63750578913
10.61.81.49,33127,74.125.24.157,443,19,12658,9,5030,10,7628,78.872432206,1.561437423,25771.1256354331,39081.9376435555
10.61.81.49,49123,91.189.89.199,123,3,270,2,180,1,90,84.711405408,32.467565497,44.3519548804192,22.1759774402096
10.61.81.49,50649,192.168.108.122,53,2,188,1,86,1,102,91.646553641,0.288280735000001,2386.56252905696,2830.57416236988
10.61.81.49,49147,216.58.196.195,443,176,157006,119,140630,57,16376,122.475209095,31.255413588,35995.0444051056,4191.52988109229
10.61.81.49,50372,216.58.200.174,443,53,38207,28,19852,25,18355,122.63600123,10.303861787,15413.2502243355,14250.9675532782
10.61.81.49,41946,192.168.108.122,53,2,215,1,88,1,127,165.712439151,0.215885649,3260.98563411224,4706.1951765029
10.61.81.49,43513,192.168.108.122,53,2,226,1,81,1,145,166.285532553,0.110622634000009,5857.75240173676,10486.0999784177
10.61.81.49,58617,192.168.108.122,53,4,523,2,199,2,324,166.285815404,135.167662217,11.7779650390356,19.176184284661
10.61.81.49,41053,172.217.166.232,443,15,7683,8,3237,7,4446,166.287167657,0.915686866000016,28280.4099977116,38842.9727679412
10.61.81.49,53713,192.168.108.122,53,2,224,1,104,1,120,166.288609846,0.241373945999982,3446.93374652815,3977.23124599402
10.61.81.49,50291,239.255.255.250,1900,4,856,4,856,0,0,182.681561004,3.00301343999999,2280.37607450735,0
10.61.81.49,53672,192.168.108.122,53,2,228,1,91,1,137,192.867084323,0.368680025000003,1974.61199586279,2972.76751025497
10.61.81.49,40837,192.168.108.122,53,2,178,1,81,1,97,192.869732535,0.70681345700001,916.790694323172,1097.88515246108
10.61.81.49,35477,172.217.160.227,443,26,14245,12,4832,14,9413,193.236914535,2.751040878,14051.408799168,27372.9120502004
10.61.81.49,48773,172.217.166.238,443,28,17597,14,7272,14,10325,193.57747696,2.38437140299999,24398.8834653878,34642.2540951773
10.61.81.49,58457,216.58.200.174,443,25,18619,11,7865,14,10754,195.029366791,2.13470328700001,29474.8222777247,40301.6196789131
10.61.81.49,54695,192.168.108.122,53,2,192,1,88,1,104,195.212839754,0.738415127000024,953.393253006823,1126.73748082625
10.61.81.49,42459,172.217.166.238,443,15,7633,7,3642,8,3991,195.443465156,1.085847839,26832.4888198264,29403.7514771903
10.61.81.49,54266,216.58.207.195,443,32,19931,15,5875,17,14056,195.956048143,2.89661027099999,16225.8625092061,38820.5486688342
10.61.81.49,45549,74.125.24.157,443,11,4131,6,2155,5,1976,196.060200702,1.116044434,15447.4136286942,14164.3105941067
10.61.81.49,48070,172.217.166.232,443,9,5932,5,3005,4,2927,207.297296977,1.126756774,21335.571753128,20781.7698906508
10.61.81.49,57618,192.168.108.122,53,2,188,1,86,1,102,214.861617249,1.53235901099998,448.980947063461,532.512286052011
10.61.81.49,56850,172.217.27.163,443,19,12379,11,6382,8,5997,216.399199784,1.63708723300002,31187.0980182517,29305.7077429419
10.61.81.49,59403,91.189.89.199,123,2,180,1,90,1,90,245.211226048,0.156426341000014,4602.80535488545,4602.80535488545
10.61.81.49,48374,192.168.108.122,53,2,226,1,81,1,145,245.446384363,0.462699928000006,1400.47568799274,2507.02437974009
10.61.81.49,34232,216.58.200.174,443,14,5609,8,3306,6,2303,245.850911533,2.67366975600001,9892.02198238873,6890.90339547527
10.61.81.49,34001,192.168.108.122,53,2,212,1,98,1,114,247.175343784,0.185930331999998,4216.63314192333,4905.06304264551
10.61.81.49,41848,192.168.108.122,53,2,262,1,86,1,176,247.461041255,0.507363365999993,1356.03010801535,2775.13138384536
10.61.81.49,48018,172.217.27.163,443,18,4687,9,2418,9,2269,249.377978657,0.846402584000003,22854.3725712443,21446.059290386
10.61.81.49,40598,192.168.108.122,53,2,264,1,100,1,164,249.732088202,0.309909075000007,2581.40230324001,4233.49977731362
10.61.81.49,51912,192.168.108.122,53,2,192,1,88,1,104,255.213883974,0.108425212000014,6492.95479357611,7673.49202877177
10.61.81.49,46937,216.239.32.116,443,24,10069,11,4237,13,5832,255.323513914,0.64096982800001,52882.3643786232,72789.6976766889
10.61.81.49,56402,192.168.108.122,53,2,232,1,100,1,132,301.416435988,0.034317799999997,23311.5176380793,30771.2032822647
10.61.81.49,47090,239.255.255.250,1900,4,856,4,856,0,0,302.68282375,3.00256172399997,2280.71914234528,0
10.61.81.49,35994,172.217.160.234,443,12,8791,5,3005,7,5786,335.837350742,0.263187273999961,91341.8024915733,175874.765130197
10.61.81.49,59451,192.168.108.122,53,2,226,1,81,1,145,356.982213276,0.203108836000013,3190.40772800234,5711.22371062147
10.61.81.49,56677,192.168.108.122,53,2,432,1,95,1,337,358.410822141,0.159781350999992,4756.50002483729,16873.0579828439
10.61.81.49,35311,172.217.160.238,443,46,34854,18,4390,28,30464,358.571676618,1.89060649699996,18576.0495670193,128906.78223455
10.61.81.49,58806,192.168.108.122,53,2,220,1,90,1,130,358.720160035,0.031937057999983,22544.3433142899,32564.0514539744
10.61.81.49,37076,216.58.200.174,443,8,4136,4,2136,4,2000,358.75627627,0.124316780000015,137455.297667764,128703.462235734
10.61.81.49,37347,192.168.108.122,53,2,180,1,82,1,98,359.113301114,0.059807079999985,10968.6010418862,13108.8158793274
10.61.81.49,56002,172.217.161.14,443,484,545985,93,9816,391,536169,359.173515881,1.13127506199999,69415.4787264293,3791608.37543509
10.61.81.49,43068,192.168.108.122,53,2,248,1,85,1,163,360.752517538,0.090899089999994,7480.82296533495,14345.5781570541
10.61.81.49,51441,192.168.108.122,53,2,245,1,104,1,141,360.752922658,0.200128382999992,4157.33134664878,5636.38192189883
10.61.81.49,42333,192.168.108.122,53,2,196,1,90,1,106,364.714727136,0.062232798999958,11569.4619488429,13626.2551841928
10.61.81.49,50713,172.217.167.46,443,17,10313,7,4675,10,5638,364.777815041,0.74397042999999,50270.8151989327,60626.0654741353
10.61.81.49,59050,192.168.108.122,53,2,188,1,86,1,102,391.653996115,0.053951046000009,12752.3014104284,15124.8226030663
10.61.81.49,44111,192.168.108.122,53,2,188,1,86,1,102,391.682841455,0.061312577999956,11221.1885789648,13308.8515704001
10.61.81.49,43695,172.217.166.238,443,190,135237,80,37178,110,98059,391.708386441,30.574467906,9727.85531098754,25657.7482365949
10.61.81.49,57372,172.217.166.3,443,18,4737,8,2356,10,2381,391.74759189,15.449863457,1219.94605664042,1232.89115486453
10.61.81.49,46484,192.168.108.122,53,2,186,1,85,1,101,407.113359279,0.032016297999974,21239.18261882,25237.1464058919
10.61.81.49,44194,216.58.200.164,443,105,60013,42,6381,63,53632,407.147577083,2.32377616700001,21967.6923814495,184637.404451011
10.61.81.49,43970,192.168.108.122,53,2,228,1,88,1,140,407.612481837,0.031735768999965,22183.1712980003,35291.4088831824
10.61.81.49,54144,172.217.167.3,443,6,3075,3,1543,3,1532,407.646121188,0.157006306000028,78621.0459597578,78060.558917919
10.61.81.49,36493,192.168.108.122,53,2,180,1,82,1,98,408.384267661,0.085517975999949,7670.90184641874,9167.66318230532
10.61.81.49,46115,192.168.108.122,53,2,414,1,86,1,328,408.384418911,0.102442834999977,6715.94065119495,25614.2852743249
10.61.81.49,44961,192.168.108.122,53,2,198,1,91,1,107,408.384538465,0.107540037000035,6769.57178283063,7959.82616222942
10.61.81.49,60168,172.217.166.14,443,15,11664,7,4483,8,7181,408.471345599,0.447320517999969,80175.1731853321,128426.928093658
10.61.81.49,59898,192.168.108.122,53,2,229,1,84,1,145,408.472741104,0.112607925999953,5967.60835467551,10301.2287074756
10.61.81.49,42045,172.217.167.3,443,10,7329,4,2935,6,4394,408.490634769,0.440264162999995,53331.6176361152,79842.9737284804
10.61.81.49,37676,192.168.108.122,53,2,180,1,82,1,98,408.492070959,0.168829254999991,3885.58250760529,4643.74494811364
10.61.81.49,51128,216.58.196.202,443,12,8799,6,4405,6,4394,408.493447231,0.639919034999991,55069.4667177708,54931.9493207457
10.61.81.49,38458,192.168.108.122,53,2,190,1,87,1,103,408.494906064,0.308020754999973,2259.58799432221,2675.14440707112
10.61.81.49,33633,172.217.167.33,443,13,10191,6,4405,7,5786,408.587845338,0.442887490999965,79568.7408565865,104514.128171671
10.61.81.49,53860,192.168.108.122,53,2,237,1,96,1,141,408.592034434,0.21561670899996,3561.87608818453,5231.50550452103
10.61.81.49,44363,172.217.166.214,443,121,83548,50,9260,71,74288,408.662694383,2.24669237500001,32972.9164634743,264523.976051682
10.61.81.49,33362,192.168.108.122,53,2,244,1,101,1,143,408.664229768,0.143425799999989,5633.57499138972,7976.24974028446
10.61.81.49,33060,172.217.166.195,443,11,7407,5,3013,6,4394,409.293222284,0.259999659999949,92707.8135410053,135200.176800258
10.61.81.49,38069,172.217.166.1,443,12,8799,5,3013,7,5786,409.295388799,0.293613526000001,82094.3106006631,157649.412922482
10.61.81.49,46774,192.168.108.122,53,2,188,1,86,1,102,409.295597566,0.054668607999986,12584.918935565,14926.2992026468
10.61.81.49,59295,172.217.27.162,443,12,8813,5,4341,7,4472,409.2960302,0.334649492999972,103774.2495549,106905.884360635
10.61.81.49,42442,172.217.161.14,443,8,4537,4,1613,4,2924,409.303108796,0.250086232000001,51598.2023352647,93535.7369053403
10.61.81.49,54939,239.255.255.250,1900,4,856,4,856,0,0,422.688705512,3.00292173399998,2280.44571474004,0
10.61.81.49,54780,192.168.108.122,53,2,200,1,92,1,108,422.695771727,0.056022994999978,13137.4625722936,15422.2386718229
10.61.81.49,60134,192.168.108.122,53,2,226,1,81,1,145,426.427581314,0.059159766999983,10953.3899956061,19607.9203625048
10.61.81.49,56314,172.217.167.14,443,21,12790,10,6116,11,6674,456.434032554,15.392186712,3178.75561903462,3468.77289101325
10.61.81.49,53635,192.168.108.122,53,2,228,1,91,1,137,456.968781136,0.37640021499999,1934.11154135504,2911.79429852353
10.61.81.49,38733,172.217.160.227,443,11,5064,5,2423,6,2641,457.349387624,15.276931159,1268.84122198721,1383.00027538927
10.61.81.49,41703,91.189.89.199,123,2,180,1,90,1,90,501.461339928,0.266732525000009,2699.33334901687,2699.33334901687
10.61.81.49,58720,239.255.255.250,1900,4,856,4,856,0,0,542.68394242,3.00337538200006,2280.10126241351,0
10.61.81.49,55426,192.168.108.122,53,2,198,1,91,1,107,567.695196694,0.069953298000087,10406.943215159,12236.7354288134
10.61.81.49,50985,216.58.200.174,443,199,161585,96,78794,103,82791,567.765554578,62.598852052,10069.705423294,10580.5135124493
10.61.81.49,33046,172.217.160.227,443,26,10508,11,6344,15,4164,568.011484755,1.12584212700006,45079.1445646424,29588.5179645604
10.61.81.49,36377,172.217.166.214,443,2888,3246663,519,51973,2369,3194690,569.923072805,36.861925645,11279.4975499712,693331.114769546
10.61.81.49,55125,172.217.167.33,443,77,49913,35,5220,42,44693,577.844948058,38.407113567,1087.29857887266,9309.3171236697
10.61.81.49,46820,192.168.108.122,53,2,412,1,94,1,318,578.773563454,0.034165075999908,22010.7808336799,74462.0032458533
10.61.81.49,37182,192.168.108.122,53,1,100,1,100,0,0,601.416310568,0,0,0
10.61.81.49,49456,192.168.108.121,53,2,232,1,100,1,132,602.2111343,0.03686268499996,21702.16304105,28646.855214186
10.61.81.49,36186,192.168.108.121,53,2,226,1,81,1,145,607.420204575,0.038774373000024,16712.0690771609,29916.6668665226
10.61.81.49,41060,192.168.108.121,53,2,220,1,90,1,130,607.548533446,0.049675707999995,14494.0058025961,20935.7861593055
10.61.81.49,39645,216.58.200.174,443,23,10510,10,4921,13,5589,607.599615089,15.3111202299999,2571.2031130723,2920.23048139831
10.61.81.49,51931,192.168.108.121,53,2,228,1,91,1,137,630.365978706,0.095032059999994,7660.57265306093,11532.9500381247
10.61.81.49,37466,172.217.160.227,443,11,5510,5,2869,6,2641,630.466534945,15.17907108,1512.08198967074,1391.91653353797
10.61.81.49,43620,239.255.255.250,1900,4,856,4,856,0,0,662.686025636,3.00248307300001,2280.77888650931,0
10.61.81.49,38200,192.168.108.121,53,2,366,1,86,1,280,663.428481647,0.238750960999937,2881.66379359697,9382.16118845524
10.61.81.49,35957,172.217.167.46,443,13,6873,6,4017,7,2856,663.672598878,0.421979128999965,76155.4252129912,54144.8579557637
10.61.81.49,53325,192.168.108.121,53,2,188,1,86,1,102,691.657598642,0.093338622999909,7371.01081939759,8742.36166951808
10.61.81.49,55049,192.168.108.121,53,2,188,1,86,1,102,691.686217906,0.065436318000025,10514.0390081199,12470.1392887004
10.61.81.49,57718,172.217.166.238,443,17,4688,9,2824,8,1864,691.754870958,0.608013348999975,37157.0789311748,24525.777311512
10.61.81.49,45850,172.217.166.3,443,19,5184,9,2430,10,2754,691.758114493,0.584191224000051,33276.7751403234,37713.6784923665
10.61.81.49,58801,91.189.89.199,123,2,180,1,90,1,90,757.961325415,0.226693999999952,3176.08758943841,3176.08758943841
10.61.81.49,49425,192.168.108.121,53,2,186,1,85,1,101,778.995367431,0.035187730000075,19324.9180893041,22962.5497296437
10.61.81.49,54530,216.58.200.164,443,80,54362,30,4739,50,49623,779.032179134,12.085769828,3136.9122976483,32847.2249306186
10.61.81.49,34772,192.168.108.121,53,2,228,1,91,1,137,779.315348632,0.276178640000012,2635.97503412997,3968.44593050336
10.61.81.49,34043,172.217.160.227,443,15,6648,8,3945,7,2703,779.595670074,15.4703760929999,2040.02797412794,1397.76821649375
10.61.81.49,42952,192.168.108.121,53,2,228,1,88,1,140,779.651331709,0.034397340999931,20466.6982834928,32560.6563601022
10.61.81.49,39710,172.217.167.3,443,6,3075,3,1543,3,1532,779.687552186,0.159400999000013,77439.9161701551,76887.849366609
10.61.81.49,59995,192.168.108.121,53,2,182,1,83,1,99,782.679655335,0.082467089000033,8051.69684114509,9603.83117196824
10.61.81.49,58443,192.168.108.121,53,2,219,1,87,1,132,782.679960113,0.089734758999953,7756.19177848761,11768.0151121881
10.61.81.49,53847,239.255.255.250,1900,4,856,4,856,0,0,782.686170543,3.00208801799999,2281.0790219809,0
10.61.81.49,50141,192.168.108.121,53,2,219,1,90,1,129,782.764812001,0.056791399999952,12677.9758907266,18171.7654433748
10.61.81.49,35487,192.168.108.121,53,2,220,1,102,1,118,782.765124896,0.059564661000081,13699.3980373511,15848.3232196807
10.61.81.49,54807,192.168.108.121,53,2,200,1,92,1,108,782.772145403,0.056277644000034,13078.0172673817,15352.4550530134
10.61.81.49,57057,192.168.108.121,53,2,212,1,98,1,114,786.233014541,0.564383526000029,1389.12630132291,1615.92243215114
10.61.81.49,38918,192.168.108.121,53,2,243,1,102,1,141,786.235972005,0.561456980999992,1453.36157108003,2009.05864237534
10.61.81.49,53088,172.217.160.234,443,31,14587,16,8325,15,6262,786.803870034,9.55850602499993,6967.61605064746,5240.98639149002
10.61.81.49,39924,192.168.108.121,53,1,99,1,99,0,0,787.4369188,0,0,0
10.61.81.49,36243,192.168.108.121,53,2,220,1,90,1,130,788.190435043,0.042617571000051,16894.440089022,24403.0801285874
10.61.81.49,40701,192.168.108.122,53,2,214,1,99,1,115,788.190649867,0.056177990999913,14098.0477568382,16376.5201215797
10.61.81.49,42539,216.58.200.174,443,15,5031,8,2478,7,2553,788.234349582,2.2310380429999,8885.54996280756,9154.48307306203
10.61.81.49,40866,192.168.108.122,53,2,226,1,93,1,133,789.641954158,0.32616215500002,2281.07396457432,3262.18104611166
10.61.81.49,40649,192.168.108.122,53,2,226,1,81,1,145,790.415853536,0.045174826999983,14344.2718662819,25678.0175384058
10.61.81.49,59049,192.168.108.122,53,2,237,1,98,1,139,790.562327388,0.064736317999973,12110.6671528697,17177.3748392744
10.61.81.49,57927,172.217.27.162,443,20,12082,10,5253,10,6829,790.629645538,0.342105882000055,122839.162408769,159693.249588708
10.61.81.49,51919,192.168.108.122,53,2,230,1,95,1,135,790.900993233,0.050870242999963,14939.971881018,21230.4863572361
10.61.81.49,59436,192.168.108.122,53,2,190,1,87,1,103,791.082286998,0.035641799000018,19527.63383239,23118.9228130595
10.61.81.49,38484,172.217.166.195,443,15,6459,8,2889,7,3570,791.119881341,15.261400965,1514.40880512899,1871.38782772948
10.61.81.49,53387,192.168.108.122,53,2,414,1,86,1,328,897.928613814,0.047993251000094,14335.3489430974,54674.3541085576
10.61.81.49,40437,172.217.167.46,443,342,223458,137,60784,205,162674,897.979178073,92.556096549,5253.80842679081,14060.5756781352
10.61.81.49,53646,192.168.108.122,53,2,251,1,103,1,148,898.30517491,0.045745320000037,18012.7715796792,25882.4290659467
10.61.81.49,42430,180.149.59.13,443,18194,21423979,2911,232126,15283,21191853,898.352136802,98.460835811,18860.3720931702,1721850.34388119
10.61.81.49,55373,192.168.108.122,53,2,228,1,91,1,137,898.47351205,0.108736681000096,6695.07284298441,10079.3953789985
10.61.81.49,49933,172.217.160.227,443,17,8882,8,4703,9,4179,898.586355908,1.15871669299997,32470.4047393929,28852.6092719377
10.61.81.49,38112,192.168.108.122,53,2,229,1,84,1,145,899.026049136,0.374198116999992,1795.84014315073,3099.96215186734
10.61.81.49,60575,192.168.108.122,53,2,180,1,82,1,98,899.041980397,0.367509540000015,1784.98767678241,2133.27795517898
10.61.81.49,57043,172.217.167.33,443,155,138890,56,7442,99,131448,899.40470588,1.46372265699995,40674.3720986223,718431.182964217
10.61.81.49,34378,172.217.166.214,443,165,103448,72,11206,93,92242,899.411967807,38.281427786,2341.81443025449,19276.6059856804
10.61.81.49,37681,192.168.108.122,53,2,212,1,98,1,114,900.252909152,0.427772725999944,1832.74891630212,2131.97322916777
10.61.81.49,49569,192.168.108.122,53,2,186,1,85,1,101,900.254074442,0.426626489,1593.90009184357,1893.92834442589
10.61.81.49,44703,172.217.160.234,443,11,4547,5,2413,6,2134,900.683392318,0.400690223000083,48176.8680440101,42606.4800687599
10.61.81.49,47139,216.58.200.164,443,19,9548,10,5466,9,4082,900.68551061,0.695943620999969,62832.6759244797,46923.3412227819
10.61.81.49,59647,192.168.108.122,53,2,190,1,87,1,103,901.007406184,1.14927162799995,605.600958940604,716.975847941175
10.61.81.49,48742,192.168.108.122,53,2,232,1,100,1,132,901.416061584,0.176653304000069,4528.64442320131,5977.81063862573
10.61.81.49,58518,192.168.108.122,53,4,522,2,200,2,322,901.416612919,1.15126002199997,1389.7816040033,2237.54838244532
10.61.81.49,45857,192.168.108.121,53,2,190,1,87,1,103,901.961359471,0.187566271999913,3710.68845469362,4393.11391762578
10.61.81.49,55750,172.217.161.3,443,31,17199,14,8072,17,9127,902.153104483,2.47115163299998,26131.945582637,29547.357201775
10.61.81.49,40352,239.255.255.250,1900,4,856,4,856,0,0,902.687537463,3.00136433499995,2281.6290312186,0
10.61.81.49,52183,192.168.108.122,53,2,237,1,96,1,141,937.630654756,0.059735051999951,12856.7729379499,18883.385252614
10.61.81.49,51347,172.217.166.1,443,950,1093735,166,14267,784,1079468,937.692104743,1.73489827500009,65788.2952820355,4977665.90954709
10.61.81.49,34947,192.168.108.122,53,2,251,1,103,1,148,945.418590893,2.382408145,345.868528752868,496.97613840218
10.61.81.49,47607,192.168.108.121,53,2,251,1,103,1,148,946.211386497,2.08009043200002,396.136623352341,569.206021904335
10.61.81.49,43259,192.168.108.122,53,2,251,1,103,1,148,947.211215481,1.77908927500005,463.158320146682,665.509042540863
10.61.81.49,34639,192.168.108.121,53,2,251,1,103,1,148,948.961195536,0.679374863000021,1212.87972940496,1742.77864031005
10.61.81.49,57635,74.125.169.7,443,24,16367,11,5495,13,10872,949.645234599,0.218493147000004,201196.241637726,398071.981635188
10.61.81.49,58556,192.168.108.121,53,2,228,1,91,1,137,962.191595964,0.344744317999925,2111.70993106885,3179.16769842233
10.61.81.49,39373,172.217.160.227,443,11,4842,5,2201,6,2641,962.540400985,15.143600441,1162.73537911948,1395.17679975218
10.61.81.49,42034,192.168.108.121,53,2,226,1,81,1,145,971.181868868,0.061620367999922,10516.003409795,18824.944375559
10.61.81.49,58042,192.168.108.121,53,2,188,1,86,1,102,991.653208493,0.098877370000082,6958.11387377546,8252.64668750113
10.61.81.49,52299,192.168.108.121,53,2,188,1,86,1,102,991.683839408,0.069918473999906,9840.03169178049,11670.7352623443
10.61.81.49,41515,172.217.166.238,443,18,4763,9,2837,9,1926,991.756118494,0.501837690000002,45225.778079761,30703.1542409657
10.61.81.49,45610,172.217.166.3,443,18,4736,8,2355,10,2381,991.759552008,15.0508593119999,1251.75577084685,1265.57557978189
10.61.81.49,40979,192.168.108.121,53,2,220,1,90,1,130,1009.662833901,0.089284618999955,8064.09892391842,11648.1428901044
10.61.81.49,52398,216.58.200.174,443,11,5483,5,1998,6,3485,1009.757694618,0.152419702000088,104868.33257285,182915.985493685
10.61.81.49,52009,91.189.89.199,123,2,180,1,90,1,90,1014.211308097,0.216842186000008,3320.38711323438,3320.38711323438
10.61.81.49,34147,239.255.255.250,1900,4,856,4,856,0,0,1022.689625226,3.00314253699992,2280.27804728877,0
10.61.81.49,49719,192.168.108.121,53,2,414,1,86,1,328,1030.628918137,0.067718956999897,10159.6366878634,38748.3817862697
10.61.81.49,54882,172.217.167.206,443,879,582855,333,171327,546,411528,1030.698827707,303.550953354,4515.27489818684,10845.7046951212
10.61.81.49,51705,192.168.108.121,53,2,251,1,103,1,148,1034.801543228,0.034277644000213,24038.9917111832,34541.4638180108
10.61.81.49,59683,180.149.59.78,443,16893,20920270,1925,158422,14968,20761848,1034.84021916,67.5350441979999,18766.1978318145,2459386.61879071
10.61.81.49,50143,192.168.108.121,53,2,186,1,85,1,101,1035.302798316,0.056836470999997,11964.1488649082,14216.2239453615
10.61.81.49,37592,216.58.200.164,443,15,6894,7,2881,8,4013,1035.361078629,0.496729593999817,46399.490343248,64630.7375034552
10.61.81.49,59728,192.168.108.121,53,2,190,1,87,1,103,1035.800272613,0.258935024000039,2687.93301596734,3182.26552465099
10.61.81.49,52356,192.168.108.121,53,2,229,1,84,1,145,1035.84631442,0.307471749000115,2185.56664859557,3772.70433388521
10.61.81.49,45914,192.168.108.121,53,2,180,1,82,1,98,1035.846448847,0.307343484000057,2134.4197425701,2550.89188746183
10.61.81.49,36814,172.217.161.3,443,12,4957,6,2779,6,2178,1036.060643514,15.04244528,1477.95119650919,1158.32231234149
10.61.81.49,46261,172.217.167.33,443,10,5421,5,2047,5,3374,1036.157210982,0.337283929000023,48552.5653373152,80027.5307513931
10.61.81.49,42986,172.217.166.214,443,268,261572,79,9303,189,252269,1036.158797768,9.49972888599996,7834.32884170841,212443.115400294
10.61.81.49,46488,172.217.160.227,443,18,13497,9,6674,9,6823,1055.61256844,0.923823969000068,57794.5602101996,59084.8493128846
10.61.81.49,51010,192.168.108.121,53,2,192,1,88,1,104,1069.662639407,0.061819309000157,11388.0276468023,13458.5781280391
10.61.81.49,46005,172.217.17.195,443,29,14967,13,4951,16,10016,1069.729017461,16.6000515389999,2386.01668837869,4826.97296521933
10.61.81.49,37450,172.217.160.227,443,20,7829,9,3925,11,3904,1098.587164208,0.303023227999802,103622.419334865,103068.006390653
10.61.81.49,51774,192.168.108.121,53,2,182,1,83,1,99,1140.900526814,0.032029547000093,20730.8582915042,24727.1683236014
10.61.81.49,56957,239.255.255.250,1900,4,856,4,856,0,0,1142.689176181,3.00199479299999,2281.1498594095,0
10.61.81.49,50449,192.168.108.121,53,2,226,1,81,1,145,1153.42048683,0.048569576999853,13341.6850635113,23883.263385298
10.61.81.49,39378,172.217.160.227,443,22,14883,11,6604,11,8279,1165.510497346,16.3996929070001,3221.52373825542,4038.6122091182
10.61.81.49,52219,172.217.166.214,443,9,3851,5,2084,4,1767,1175.70457578,0.134839600000078,123643.20273859,104835.671419908
10.61.81.49,34885,192.168.108.121,53,2,232,1,100,1,132,1201.41648258,0.170034557000008,4704.92595219901,6210.50225690269
10.61.81.49,45648,192.168.108.121,53,2,261,1,100,1,161,1201.416903663,0.169556101999888,4718.20235641257,7596.30579382424
10.61.81.49,57192,192.168.108.121,53,2,198,1,91,1,107,1215.099252427,0.253264955000077,2874.46006890207,3379.85964145628
10.61.81.49,32867,192.168.108.121,53,2,332,1,94,1,238,1215.099417328,0.371638853999912,2023.46980652399,5123.25333992245
10.61.81.49,35441,172.217.167.33,443,9,5932,5,3005,4,2927,1215.101191795,0.558477651999965,43045.5899424271,41928.2668091461
10.61.81.49,49781,192.168.108.121,53,2,228,1,88,1,140,1215.101738657,0.369338337000045,1906.11136043512,3032.44989160133
10.61.81.49,41587,216.58.196.202,443,7,4467,4,2935,3,1532,1215.357036719,0.381747163,61506.6784399391,32105.0192061283
10.61.81.49,49588,172.217.166.214,443,165,119788,67,9766,98,110022,1215.361030137,7.96248540900001,9812.01170073,110540.359547176
10.61.81.49,45957,172.217.161.3,443,19,9242,10,6424,9,2818,1215.367095906,5.13247047200002,10013.1116740694,4392.42663411078
10.61.81.49,38842,192.168.108.121,53,2,186,1,85,1,101,1215.368782436,0.26768311800015,2540.31709238989,3018.49442742798
10.61.81.49,51883,172.217.167.3,443,7,4467,4,2935,3,1532,1215.476178689,0.269124633999809,87245.8223204372,45540.2384309744
10.61.81.49,45374,192.168.108.121,53,2,237,1,96,1,141,1215.477425088,0.160163888999932,4795.08836102453,7042.78603025478
10.61.81.49,34279,192.168.108.121,53,2,244,1,101,1,143,1215.477691294,0.161547827000049,5001.61478495005,7081.49420047383
10.61.81.49,45473,216.58.200.164,443,33,14259,15,7589,18,6670,1215.639163313,4.51920705500015,13434.2151756085,11807.3811070376
10.61.81.49,39985,192.168.108.121,53,2,180,1,82,1,98,1215.639820089,0.043622122999977,15038.2410319723,17972.53196504
10.61.81.49,33825,172.217.166.1,443,6,3075,3,1543,3,1532,1215.641253414,0.214119940000046,57649.9320894511,57238.9474796106
10.61.81.49,42909,172.217.27.162,443,6,3075,3,1543,3,1532,1215.643202933,0.212173384999915,58178.8333159928,57764.0781854187
10.61.81.49,53743,172.217.161.14,443,6,3075,3,1543,3,1532,1215.687992725,0.167388683000127,73744.5314626836,73218.8089441551
10.61.81.49,53063,180.149.59.78,443,10675,13017092,1364,112707,9311,12904385,1215.795076439,71.887807267,12542.5441987838,1436058.26808116
10.61.81.49,45674,172.217.167.3,443,6,3075,3,1543,3,1532,1215.817829896,0.158149086000094,78052.9329141533,77496.4959329118
10.61.81.49,50089,192.168.108.121,53,1,136,1,136,0,0,1217.586950637,0,0,0
10.61.81.49,43472,192.168.108.121,53,2,220,1,90,1,130,1217.630260517,0.539306744000214,1335.04727691615,1928.40162221221
10.61.81.49,43040,216.58.200.174,443,18,11384,10,5052,8,6332,1218.170994889,4.42831084399995,9126.73058052391,11439.1247101895
10.61.81.49,52974,192.168.108.122,53,2,288,1,136,1,152,1218.461229074,1.15318368400017,943.4750205847,1054.47208182996
10.61.81.49,50248,192.168.108.122,53,2,228,1,91,1,137,1232.524338197,0.096995109000091,7505.53308826449,11299.5388251894
10.61.81.49,34798,172.217.160.227,443,11,5056,5,2415,6,2641,1232.626201876,0.277660047999916,69581.4905283235,76093.050304473
10.61.81.49,59062,192.168.108.122,53,2,302,1,143,1,159,1232.704274843,0.120847846000061,9466.4492406379,10525.6323724575
10.61.81.49,51187,192.168.108.122,53,2,302,1,143,1,159,1232.704631859,0.400347320000037,2857.51881641144,3177.24120146447
10.61.81.49,57554,239.255.255.250,1900,4,856,4,856,0,0,1262.690167669,3.00289040400003,2280.46950727141,0
10.61.81.49,41735,192.168.108.122,53,2,302,1,143,1,159,1262.704588692,0.165779451999924,6900.73459767814,7672.84476245332
10.61.81.49,37937,192.168.108.122,53,2,188,1,86,1,102,1291.668616335,0.056804549999924,12111.7058404814,14365.0464619663
10.61.81.49,45028,192.168.108.122,53,2,188,1,86,1,102,1291.699763935,0.057630173999996,11938.1905735708,14159.2492849328
10.61.81.49,54128,172.217.166.238,443,16,4626,9,2824,7,1802,1291.726842753,0.609889824999982,37042.7560420452,23637.0560863192
10.61.81.49,40944,172.217.166.3,443,24,7185,12,4350,12,2835,1291.758814522,15.438425885,2254.11581849233,1469.06168860362
10.61.81.49,38195,192.168.108.122,53,2,186,1,85,1,101,1294.161401642,1.03538641399996,656.759631771667,780.384974222805
10.61.81.49,53217,192.168.108.121,53,2,186,1,85,1,101,1294.961449332,0.033597039999904,20239.8782750486,24049.7377150578
10.61.81.49,60307,216.58.200.164,443,82,57190,32,6082,50,51108,1294.999668887,9.65998046599998,5036.86318737946,42325.5514272591
10.61.81.49,37352,192.168.108.121,53,2,228,1,88,1,140,1295.390123815,0.035272831000157,19958.7041935158,31752.4839442296
10.61.81.49,56326,172.217.167.3,443,6,3075,3,1543,3,1532,1295.427473676,0.123965496999972,99576.0941449926,98866.2192029349
10.61.81.49,53383,192.168.108.121,53,2,220,1,90,1,130,1299.478330376,0.034089721999862,21120.7354522547,30507.7289865901
10.61.81.49,57088,216.58.200.174,443,9,4250,5,2520,4,1730,1299.514088165,0.118936546999976,169502.146384022,116364.568747761
10.61.81.49,39588,192.168.108.121,53,2,207,1,85,1,122,1300.448506775,0.036581240000032,18588.7629834145,26680.3421644302
10.61.81.49,56109,216.58.196.206,443,30,22527,12,3142,18,19385,1300.486594152,0.332211615999995,75662.6162042461,466810.889598762
10.61.81.49,53727,192.168.108.121,53,2,188,1,86,1,102,1300.828589617,0.05212227800007,13199.7300655025,15655.4937986192
10.61.81.49,49595,192.168.108.121,53,2,209,1,86,1,123,1300.828976478,0.051752864000037,13293.9502633036,19013.4404928645
10.61.81.49,34937,172.217.166.206,443,22,11926,9,2839,13,9087,1300.882168213,15.0780230409998,1506.29826856227,4821.32172117834
10.61.81.49,60963,172.217.167.227,443,6,3075,3,1543,3,1532,1300.883237463,0.148951118000014,82872.8254325615,82282.0275843709
10.61.81.49,34893,192.168.108.121,53,2,188,1,86,1,102,1302.450827809,0.064097317000005,10733.6786031145,12730.642064159
10.61.81.49,49525,172.217.167.14,443,19,6968,9,4069,10,2899,1302.521426617,16.2586232389999,2002.13754396601,1426.44304250614
10.61.81.49,34299,192.168.108.121,53,2,251,1,103,1,148,1303.653897928,0.113242340999932,7276.43028856579,10455.4532301722
10.61.81.49,45666,180.149.59.79,443,3338,4029611,448,44673,2890,3984938,1303.771515006,19.0085020429999,18801.2710939319,1677118.16154077
10.61.81.49,32936,192.168.108.121,53,2,212,1,98,1,114,1304.247058159,0.125540842999953,6244.97957210859,7264.56807367733
10.61.81.49,41898,192.168.108.121,53,2,180,1,82,1,98,1304.337788131,0.118045667999922,5557.17131441394,6641.49742454348
10.61.81.49,34845,172.217.160.234,443,12,4604,6,2477,6,2127,1304.374154144,15.0374614120001,1317.77561764425,1131.57397607159
10.61.81.49,46547,172.217.166.214,443,27,14232,13,3109,14,11123,1304.457137373,0.944777896999994,26325.7640541522,94185.0992519573
10.61.81.49,49475,192.168.108.121,53,2,190,1,87,1,103,1304.556687387,0.102964361999966,6759.62038205248,8002.76895806213
10.61.81.49,39178,172.217.161.3,443,18,6266,9,3000,9,3266,1304.661495781,0.675386546000027,35535.2059381992,38685.9941980529
10.61.81.49,42145,192.168.108.121,53,2,229,1,84,1,145,1305.174757778,0.224998335999999,2986.6887548893,5155.5936840351
10.61.81.49,60727,172.217.167.33,443,9,3814,4,1986,5,1828,1305.401707317,0.209910722999894,75689.320549899,69667.7129734217
10.61.81.49,41207,192.168.108.121,53,2,226,1,81,1,145,1335.43444184,0.052244450999979,12403.2311106162,22203.3149511031
fe80::112d:a32d:9c97:8a2,5353,ff02::fb,5353,2,214,2,214,0,0,221.197761107,512.002181385,3.34373575395504,0
